≈≈≈≈≈≈≈≈≈≈≈≈≈≈≈≈≈≈≈≈≈≈≈≈≈≈≈≈≈≈≈≈≈≈≈≈≈≈≈≈≈≈≈≈≈≈≈≈≈≈≈≈≈
≈≈≈¬≈≈≈≈≈≈≈≈≈≈≈≈≈↟↟≈≈≈≈≈≈≈≈≈≈≈≈≈≈≈≈≈≈≈≈≈≈≈≈≈≈≈≈≈≈≈≈≈≈
≈≈≈≈≈≈≈≈≈≈≈≈≈≈≈≈↟↟↟↟↟↟↟≈≈≈¬≈≈≈≈≈≈≈≈≈≈≈≈<>≈≈≈≈≈≈≈≈≈≈≈≈
≈≈≈≈≈≈≈≈≈≈≈≈≈≈≈↟↟↟↟⌂⌂⌂↟↟≡≡≡≡≡≡≡≡↟↟↟≈≈≈≈≈\/\/\≈≈≈≈≈≈≈≈
≈≈≈≈≈≡≡≡↟≡≡↟↟↟↟↟↟↟↟↟↟↟↟↟↟≡≡≡↟↟↟≈≈≈≈≈≈≈≈≈≈≈≈≈≈≈≈≈≈≈≈≈≈
≈≈≈≈≈≈≈≡≡↟↟↟↟↟↟↟⌂⌂⌂⌂↟⤊⤊↟↟↟↟↟↟↟↟≈≈≈≈≈≈≈≈≈≈≈≈≈≈≈≈≈≈¬≈≈≈
≈≈≈≈≈≈≈≡≡≡↟↟↟↟↟⟰⟰↟⌂⌂⌂⌂↟↟↟↟↟↟↟↟↟↟↟↟≈≈≈≈≈≈≈≈≈≈≈≈≈≈≈≈≈≈≈
≈¬≈≈≈≈≈≡↟↟↟↟↟↟↟↟⌂⌂⌂↟↟↟⟰⟰↟↟↟↟↟↟↟↟↟⇞⇞⇞⇞⇞⇞⇞⇞⇞≈≈≈≈≈≈≈≈≈≈≈
≈≈≈≈≈≈≈≡≡↟↟↟↟↟↟↟↟↟⟰⤊↟⌂⌂↟↟↟↟↟↟↟↟↟↟⇞⇞⇞⇞⇞⇞⇞⇞⇞⇞⇞⇞⇞⇞⇞≈≈≈≈≈
≈≈≈≈≈≈≈≈≈≈≈↟↟↟↟↟↟↟↟↟↟↟↟↟↟↟↟↟↟↟↟↟↟⇞⇞⇞⇞⇞⇞⇞⇞⇞⇞⇞⇞⇞⇞⇞⇞⇞⇞⇞≈
≈{«≈≈≈≈≈≈≈≈≡↟↟⤊↟↟↟↟↟↟↟↟↟↟↟↟↟↟↟↟↟↟⇞⇞⇞⇞⇞⇞⇞⇞⇞⇞⇞⇞⇞⇞⇞⇞⇞⇞⇞≈
≈≈««>≈≈≈≈≈≈≡≡↟⤊⤊↟↟≡≡≡↟↟≡↟↟↟↟≈≈≈≈⇞⇞⇞⇞⇞⇞⇞⇞⇞⇞⇞⇞⇞⇞⇞⇞⇞⇞⇞⇞⇞
≈≈≈≈≈≈≈≈≈≈≈≡≡≡≡≡≡≡≡≡≡≡≡≡↟↟↟↟≈≈⇞⇞⇞⇞⇞⇞⇞⇞⇞⇞⇞⇞⇞⇞⇞⇞⇞⇞⇞⇞⇞⇞⇞
≈≈≈≈≈≈≈≈≈¬≈≈≈≈≈≈≈≈≈≈≈≈≈≈≈≈≈≈⇞⇞⇞⇞⇞⇞⇞⇞⇞⇞⇞⇞⇞⇞⇞⇞⇞⇞⇞⇞⇞⇞⇞⇞⇞
